"","date","type","nameSubs","personTrans","cat","subCat","amount","balance"
"1",2017-01-01,"FPN","noSubs","biel","noCat","noSubCat",-24,2000
"2",2017-01-01,"FPP","noSubs","father","noCat","noSubCat",174,2174
"3",2017-01-01,"POS","noSubs","noPerson","restaurant","drinks",-11,2163
"4",2017-01-01,"POS","noSubs","noPerson","restaurant","healthyfood",-26,2137
"5",2017-01-03,"ATM","noSubs","noPerson","noCat","noSubCat",-49,2088
"6",2017-01-03,"POS","noSubs","noPerson","shopping","groceries",-13,2075
"7",2017-01-04,"ATM","noSubs","noPerson","noCat","noSubCat",-32,2043
"8",2017-01-04,"FPN","noSubs","biel","noCat","noSubCat",-39,2004
"9",2017-01-04,"POS","noSubs","noPerson","restaurant","drinks",-20,1984
"10",2017-01-04,"POS","noSubs","noPerson","transport","subway",-7,1977
"11",2017-01-05,"POS","noSubs","noPerson","restaurant","fastfood",-6,1971
"12",2017-01-05,"POS","noSubs","noPerson","restaurant","fastfood",-7,1964
"13",2017-01-05,"POS","noSubs","noPerson","restaurant","drinks",-29,1935
"14",2017-01-06,"ATM","noSubs","noPerson","noCat","noSubCat",-48,1887
"15",2017-01-06,"ATM","noSubs","noPerson","noCat","noSubCat",-26,1861
"16",2017-01-06,"POS","noSubs","noPerson","shopping","groceries",-27,1834
"17",2017-01-06,"POS","noSubs","noPerson","restaurant","fastfood",-5,1829
"18",2017-01-06,"POS","noSubs","noPerson","shopping","groceries",-27,1802
"19",2017-01-06,"POS","noSubs","noPerson","restaurant","fastfood",-10,1792
"20",2017-01-07,"POS","noSubs","noPerson","restaurant","healthyfood",-27,1765
"21",2017-01-07,"POS","noSubs","noPerson","travelling","flights",-144,1621
"22",2017-01-07,"POS","noSubs","noPerson","shopping","healthcare",-18,1603
"23",2017-01-07,"POS","noSubs","noPerson","shopping","groceries",-11,1592
"24",2017-01-08,"FPN","noSubs","sergi","noCat","noSubCat",-22,1570
"25",2017-01-08,"POS","noSubs","noPerson","restaurant","drinks",-15,1555
"26",2017-01-08,"POS","noSubs","noPerson","restaurant","healthyfood",-20,1535
"27",2017-01-09,"FPN","noSubs","biel","noCat","noSubCat",-21,1514
"28",2017-01-09,"POS","noSubs","noPerson","restaurant","drinks",-24,1490
"29",2017-01-10,"POS","noSubs","noPerson","shopping","clothes",-63,1427
"30",2017-01-11,"POS","noSubs","noPerson","restaurant","drinks",-21,1406
"31",2017-01-11,"POS","noSubs","noPerson","restaurant","drinks",-26,1380
"32",2017-01-11,"POS","noSubs","noPerson","restaurant","fastfood",-7,1373
"33",2017-01-11,"POS","noSubs","noPerson","shopping","clothes",-62,1311
"34",2017-01-12,"FPN","noSubs","sergi","noCat","noSubCat",-21,1290
"35",2017-01-12,"FPN","noSubs","sergi","noCat","noSubCat",-34,1256
"36",2017-01-12,"POS","noSubs","noPerson","restaurant","fastfood",-10,1246
"37",2017-01-12,"POS","noSubs","noPerson","shopping","clothes",-76,1170
"38",2017-01-12,"POS","noSubs","noPerson","travelling","car",-11,1159
"39",2017-01-12,"POS","noSubs","noPerson","restaurant","drinks",-15,1144
"40",2017-01-12,"POS","noSubs","noPerson","travelling","flights",-193,951
"41",2017-01-12,"POS","noSubs","noPerson","shopping","groceries",-12,939
"42",2017-01-12,"POS","noSubs","noPerson","restaurant","drinks",-20,919
"43",2017-01-13,"ATM","noSubs","noPerson","noCat","noSubCat",-20,899
"44",2017-01-13,"POS","noSubs","noPerson","shopping","groceries",-16,883
"45",2017-01-14,"ATM","noSubs","noPerson","noCat","noSubCat",-34,849
"46",2017-01-14,"POS","noSubs","noPerson","restaurant","drinks",-17,832
"47",2017-01-14,"POS","noSubs","noPerson","travelling","train",-23,809
"48",2017-01-15,"POS","noSubs","noPerson","shopping","clothes",-44,765
"49",2017-01-15,"POS","noSubs","noPerson","travelling","flights",-184,581
"50",2017-01-16,"POS","noSubs","noPerson","restaurant","fastfood",-7,574
"51",2017-01-16,"POS","noSubs","noPerson","restaurant","fastfood",-6,568
"52",2017-01-16,"POS","noSubs","noPerson","shopping","groceries",-18,550
"53",2017-01-16,"POS","noSubs","noPerson","restaurant","drinks",-28,522
"54",2017-01-16,"POS","noSubs","noPerson","transport","uber",-11,511
"55",2017-01-17,"POS","noSubs","noPerson","travelling","flights",-94,417
"56",2017-01-17,"POS","noSubs","noPerson","transport","subway",-7,410
"57",2017-01-17,"POS","noSubs","noPerson","transport","uber",-19,391
"58",2017-01-18,"POS","noSubs","noPerson","restaurant","fastfood",-10,381
"59",2017-01-18,"POS","noSubs","noPerson","restaurant","fastfood",-9,372
"60",2017-01-18,"POS","noSubs","noPerson","travelling","flights",-169,203
"61",2017-01-18,"POS","noSubs","noPerson","restaurant","fastfood",-6,197
"62",2017-01-18,"POS","noSubs","noPerson","restaurant","healthyfood",-27,170
"63",2017-01-19,"POS","noSubs","noPerson","shopping","groceries",-30,140
"64",2017-01-19,"POS","noSubs","noPerson","shopping","clothes",-50,90
"65",2017-01-20,"ATM","noSubs","noPerson","noCat","noSubCat",-38,52
"66",2017-01-20,"FPN","noSubs","biel","noCat","noSubCat",-31,21
"67",2017-01-20,"POS","noSubs","noPerson","restaurant","drinks",-6,15
"68",2017-01-20,"POS","noSubs","noPerson","travelling","car",-14,1
"69",2017-01-20,"POS","noSubs","noPerson","restaurant","fastfood",-10,-9
"70",2017-01-20,"POS","noSubs","noPerson","shopping","groceries",-27,-36
"71",2017-01-21,"POS","noSubs","noPerson","shopping","groceries",-13,-49
"72",2017-01-21,"POS","noSubs","noPerson","shopping","groceries",-21,-70
"73",2017-01-21,"POS","noSubs","noPerson","restaurant","drinks",-10,-80
"74",2017-01-22,"ATM","noSubs","noPerson","noCat","noSubCat",-42,-122
"75",2017-01-22,"POS","noSubs","noPerson","restaurant","fastfood",-9,-131
"76",2017-01-23,"ATM","noSubs","noPerson","noCat","noSubCat",-47,-178
"77",2017-01-23,"POS","noSubs","noPerson","restaurant","drinks",-9,-187
"78",2017-01-23,"POS","noSubs","noPerson","shopping","groceries",-28,-215
"79",2017-01-24,"FPN","noSubs","biel","noCat","noSubCat",-39,-254
"80",2017-01-24,"FPN","noSubs","sergi","noCat","noSubCat",-24,-278
"81",2017-01-24,"POS","noSubs","noPerson","shopping","groceries",-16,-294
"82",2017-01-24,"POS","noSubs","noPerson","transport","uber",-12,-306
"83",2017-01-25,"POS","noSubs","noPerson","restaurant","drinks",-25,-331
"84",2017-01-25,"POS","noSubs","noPerson","restaurant","drinks",-10,-341
"85",2017-01-26,"FPN","noSubs","sergi","noCat","noSubCat",-24,-365
"86",2017-01-26,"POS","noSubs","noPerson","shopping","clothes",-55,-420
"87",2017-01-26,"POS","noSubs","noPerson","restaurant","drinks",-26,-446
"88",2017-01-27,"POS","noSubs","noPerson","restaurant","drinks",-24,-470
"89",2017-01-27,"POS","noSubs","noPerson","restaurant","healthyfood",-23,-493
"90",2017-01-28,"POS","noSubs","noPerson","shopping","clothes",-46,-539
"91",2017-01-28,"POS","noSubs","noPerson","travelling","flights",-123,-662
"92",2017-01-29,"POS","noSubs","noPerson","restaurant","fastfood",-9,-671
"93",2017-01-29,"POS","noSubs","noPerson","restaurant","drinks",-30,-701
"94",2017-01-29,"POS","noSubs","noPerson","shopping","healthcare",-13,-714
"95",2017-01-29,"POS","noSubs","noPerson","shopping","clothes",-40,-754
"96",2017-01-30,"POS","noSubs","noPerson","restaurant","drinks",-30,-784
"97",2017-01-30,"POS","noSubs","noPerson","restaurant","fastfood",-7,-791
"98",2017-01-31,"BACS","noSubs","noPerson","noCat","noSubCat",2000,1209
"99",2017-01-31,"DD","amazon","noPerson","noCat","noSubCat",-4,1205
"100",2017-01-31,"DD","gym","noPerson","noCat","noSubCat",-40,1165
"101",2017-01-31,"DD","netflix","noPerson","noCat","noSubCat",-8,1157
"102",2017-01-31,"DD","spotify","noPerson","noCat","noSubCat",-10,1147
"103",2017-01-31,"POS","noSubs","noPerson","shopping","healthcare",-13,1134
"104",2017-01-31,"POS","noSubs","noPerson","shopping","healthcare",-13,1121
"105",2017-01-31,"POS","noSubs","noPerson","restaurant","drinks",-17,1104
"106",2017-02-01,"FPP","noSubs","father","noCat","noSubCat",102,1206
"107",2017-02-01,"POS","noSubs","noPerson","transport","uber",-12,1194
"108",2017-02-01,"POS","noSubs","noPerson","shopping","groceries",-14,1180
"109",2017-02-01,"POS","noSubs","noPerson","restaurant","fastfood",-7,1173
"110",2017-02-03,"POS","noSubs","noPerson","restaurant","drinks",-24,1149
"111",2017-02-04,"ATM","noSubs","noPerson","noCat","noSubCat",-34,1115
"112",2017-02-04,"FPN","noSubs","sergi","noCat","noSubCat",-40,1075
"113",2017-02-04,"POS","noSubs","noPerson","restaurant","fastfood",-6,1069
"114",2017-02-04,"POS","noSubs","noPerson","shopping","groceries",-23,1046
"115",2017-02-04,"POS","noSubs","noPerson","restaurant","fastfood",-7,1039
"116",2017-02-04,"POS","noSubs","noPerson","shopping","groceries",-21,1018
"117",2017-02-05,"POS","noSubs","noPerson","restaurant","drinks",-8,1010
"118",2017-02-06,"ATM","noSubs","noPerson","noCat","noSubCat",-46,964
"119",2017-02-06,"ATM","noSubs","noPerson","noCat","noSubCat",-28,936
"120",2017-02-06,"POS","noSubs","noPerson","shopping","groceries",-13,923
"121",2017-02-06,"POS","noSubs","noPerson","shopping","groceries",-15,908
"122",2017-02-06,"POS","noSubs","noPerson","restaurant","healthyfood",-28,880
"123",2017-02-06,"POS","noSubs","noPerson","restaurant","fastfood",-5,875
"124",2017-02-08,"FPN","noSubs","sergi","noCat","noSubCat",-27,848
"125",2017-02-08,"POS","noSubs","noPerson","restaurant","drinks",-11,837
"126",2017-02-08,"POS","noSubs","noPerson","restaurant","fastfood",-9,828
"127",2017-02-09,"FPP","noSubs","father","noCat","noSubCat",181,1009
"128",2017-02-09,"POS","noSubs","noPerson","restaurant","drinks",-23,986
"129",2017-02-10,"ATM","noSubs","noPerson","noCat","noSubCat",-49,937
"130",2017-02-10,"POS","noSubs","noPerson","shopping","healthcare",-11,926
"131",2017-02-10,"POS","noSubs","noPerson","restaurant","drinks",-24,902
"132",2017-02-11,"FPN","noSubs","biel","noCat","noSubCat",-31,871
"133",2017-02-11,"FPP","noSubs","mother","noCat","noSubCat",168,1039
"134",2017-02-11,"POS","noSubs","noPerson","transport","bus",-7,1032
"135",2017-02-11,"POS","noSubs","noPerson","travelling","flights",-182,850
"136",2017-02-11,"POS","noSubs","noPerson","restaurant","drinks",-29,821
"137",2017-02-11,"POS","noSubs","noPerson","shopping","clothes",-78,743
"138",2017-02-11,"POS","noSubs","noPerson","travelling","flights",-139,604
"139",2017-02-12,"ATM","noSubs","noPerson","noCat","noSubCat",-42,562
"140",2017-02-12,"POS","noSubs","noPerson","shopping","groceries",-27,535
"141",2017-02-13,"FPN","noSubs","biel","noCat","noSubCat",-34,501
"142",2017-02-13,"FPN","noSubs","sergi","noCat","noSubCat",-33,468
"143",2017-02-14,"FPN","noSubs","sergi","noCat","noSubCat",-40,428
"144",2017-02-14,"POS","noSubs","noPerson","restaurant","drinks",-15,413
"145",2017-02-14,"POS","noSubs","noPerson","shopping","groceries",-11,402
"146",2017-02-14,"POS","noSubs","noPerson","travelling","train",-11,391
"147",2017-02-14,"POS","noSubs","noPerson","restaurant","fastfood",-8,383
"148",2017-02-14,"POS","noSubs","noPerson","restaurant","drinks",-24,359
"149",2017-02-15,"FPP","noSubs","father","noCat","noSubCat",164,523
"150",2017-02-15,"POS","noSubs","noPerson","travelling","flights",-197,326
"151",2017-02-15,"POS","noSubs","noPerson","restaurant","fastfood",-8,318
"152",2017-02-16,"POS","noSubs","noPerson","travelling","car",-23,295
"153",2017-02-16,"POS","noSubs","noPerson","travelling","train",-21,274
"154",2017-02-16,"POS","noSubs","noPerson","restaurant","drinks",-15,259
"155",2017-02-17,"FPP","noSubs","father","noCat","noSubCat",155,414
"156",2017-02-17,"POS","noSubs","noPerson","restaurant","fastfood",-8,406
"157",2017-02-17,"POS","noSubs","noPerson","shopping","groceries",-26,380
"158",2017-02-17,"POS","noSubs","noPerson","shopping","groceries",-23,357
"159",2017-02-18,"POS","noSubs","noPerson","restaurant","healthyfood",-23,334
"160",2017-02-18,"POS","noSubs","noPerson","shopping","groceries",-14,320
"161",2017-02-19,"ATM","noSubs","noPerson","noCat","noSubCat",-20,300
"162",2017-02-19,"POS","noSubs","noPerson","travelling","train",-28,272
"163",2017-02-19,"POS","noSubs","noPerson","shopping","groceries",-12,260
"164",2017-02-19,"POS","noSubs","noPerson","shopping","groceries",-26,234
"165",2017-02-20,"POS","noSubs","noPerson","shopping","groceries",-11,223
"166",2017-02-20,"POS","noSubs","noPerson","shopping","clothes",-73,150
"167",2017-02-20,"POS","noSubs","noPerson","shopping","clothes",-41,109
"168",2017-02-20,"POS","noSubs","noPerson","restaurant","fastfood",-10,99
"169",2017-02-21,"FPN","noSubs","sergi","noCat","noSubCat",-26,73
"170",2017-02-21,"FPP","noSubs","father","noCat","noSubCat",194,267
"171",2017-02-21,"POS","noSubs","noPerson","restaurant","drinks",-5,262
"172",2017-02-21,"POS","noSubs","noPerson","shopping","groceries",-18,244
"173",2017-02-21,"POS","noSubs","noPerson","shopping","groceries",-15,229
"174",2017-02-21,"POS","noSubs","noPerson","shopping","groceries",-10,219
"175",2017-02-21,"POS","noSubs","noPerson","restaurant","fastfood",-8,211
"176",2017-02-22,"POS","noSubs","noPerson","shopping","groceries",-25,186
"177",2017-02-22,"POS","noSubs","noPerson","restaurant","fastfood",-10,176
"178",2017-02-22,"POS","noSubs","noPerson","restaurant","healthyfood",-29,147
"179",2017-02-23,"FPP","noSubs","father","noCat","noSubCat",138,285
"180",2017-02-23,"POS","noSubs","noPerson","restaurant","drinks",-17,268
"181",2017-02-24,"ATM","noSubs","noPerson","noCat","noSubCat",-47,221
"182",2017-02-24,"POS","noSubs","noPerson","restaurant","healthyfood",-30,191
"183",2017-02-24,"POS","noSubs","noPerson","shopping","clothes",-77,114
"184",2017-02-24,"POS","noSubs","noPerson","shopping","healthcare",-14,100
"185",2017-02-25,"ATM","noSubs","noPerson","noCat","noSubCat",-22,78
"186",2017-02-25,"FPN","noSubs","sergi","noCat","noSubCat",-24,54
"187",2017-02-25,"POS","noSubs","noPerson","shopping","healthcare",-14,40
"188",2017-02-25,"POS","noSubs","noPerson","shopping","groceries",-24,16
"189",2017-02-25,"POS","noSubs","noPerson","shopping","groceries",-28,-12
"190",2017-02-26,"POS","noSubs","noPerson","transport","uber",-14,-26
"191",2017-02-26,"POS","noSubs","noPerson","restaurant","healthyfood",-20,-46
"192",2017-02-26,"POS","noSubs","noPerson","restaurant","fastfood",-7,-53
"193",2017-02-27,"ATM","noSubs","noPerson","noCat","noSubCat",-47,-100
"194",2017-02-28,"BACS","noSubs","noPerson","noCat","noSubCat",2000,1900
"195",2017-02-28,"DD","amazon","noPerson","noCat","noSubCat",-4,1896
"196",2017-02-28,"DD","gym","noPerson","noCat","noSubCat",-40,1856
"197",2017-02-28,"DD","netflix","noPerson","noCat","noSubCat",-8,1848
"198",2017-02-28,"DD","spotify","noPerson","noCat","noSubCat",-10,1838
"199",2017-02-28,"FPN","noSubs","biel","noCat","noSubCat",-37,1801
"200",2017-02-28,"FPN","noSubs","biel","noCat","noSubCat",-37,1764
"201",2017-02-28,"POS","noSubs","noPerson","shopping","clothes",-26,1738
"202",2017-02-28,"POS","noSubs","noPerson","restaurant","fastfood",-6,1732
"203",2017-03-02,"ATM","noSubs","noPerson","noCat","noSubCat",-47,1685
"204",2017-03-02,"POS","noSubs","noPerson","shopping","groceries",-14,1671
"205",2017-03-02,"POS","noSubs","noPerson","travelling","train",-29,1642
"206",2017-03-02,"POS","noSubs","noPerson","restaurant","drinks",-22,1620
"207",2017-03-03,"FPN","noSubs","biel","noCat","noSubCat",-30,1590
"208",2017-03-04,"FPN","noSubs","biel","noCat","noSubCat",-34,1556
"209",2017-03-04,"POS","noSubs","noPerson","transport","subway",-5,1551
"210",2017-03-04,"POS","noSubs","noPerson","transport","uber",-18,1533
"211",2017-03-05,"FPN","noSubs","biel","noCat","noSubCat",-29,1504
"212",2017-03-05,"POS","noSubs","noPerson","shopping","groceries",-16,1488
"213",2017-03-05,"POS","noSubs","noPerson","shopping","groceries",-11,1477
"214",2017-03-06,"POS","noSubs","noPerson","restaurant","fastfood",-5,1472
"215",2017-03-07,"ATM","noSubs","noPerson","noCat","noSubCat",-31,1441
"216",2017-03-07,"POS","noSubs","noPerson","travelling","train",-23,1418
"217",2017-03-07,"POS","noSubs","noPerson","transport","subway",-5,1413
"218",2017-03-07,"POS","noSubs","noPerson","shopping","clothes",-36,1377
"219",2017-03-08,"POS","noSubs","noPerson","transport","uber",-14,1363
"220",2017-03-08,"POS","noSubs","noPerson","shopping","groceries",-29,1334
"221",2017-03-09,"POS","noSubs","noPerson","restaurant","drinks",-27,1307
"222",2017-03-09,"POS","noSubs","noPerson","restaurant","fastfood",-8,1299
"223",2017-03-09,"POS","noSubs","noPerson","restaurant","fastfood",-5,1294
"224",2017-03-09,"POS","noSubs","noPerson","restaurant","drinks",-26,1268
"225",2017-03-09,"POS","noSubs","noPerson","travelling","flights",-88,1180
"226",2017-03-10,"POS","noSubs","noPerson","shopping","groceries",-27,1153
"227",2017-03-10,"POS","noSubs","noPerson","travelling","train",-13,1140
"228",2017-03-10,"POS","noSubs","noPerson","restaurant","fastfood",-7,1133
"229",2017-03-11,"FPP","noSubs","mother","noCat","noSubCat",119,1252
"230",2017-03-11,"POS","noSubs","noPerson","shopping","groceries",-11,1241
"231",2017-03-11,"POS","noSubs","noPerson","travelling","flights",-103,1138
"232",2017-03-11,"POS","noSubs","noPerson","shopping","healthcare",-17,1121
"233",2017-03-11,"POS","noSubs","noPerson","shopping","groceries",-22,1099
"234",2017-03-11,"POS","noSubs","noPerson","transport","subway",-7,1092
"235",2017-03-12,"ATM","noSubs","noPerson","noCat","noSubCat",-50,1042
"236",2017-03-12,"ATM","noSubs","noPerson","noCat","noSubCat",-26,1016
"237",2017-03-12,"FPN","noSubs","biel","noCat","noSubCat",-28,988
"238",2017-03-12,"POS","noSubs","noPerson","travelling","car",-27,961
"239",2017-03-12,"POS","noSubs","noPerson","restaurant","healthyfood",-29,932
"240",2017-03-13,"ATM","noSubs","noPerson","noCat","noSubCat",-28,904
"241",2017-03-13,"POS","noSubs","noPerson","travelling","flights",-137,767
"242",2017-03-13,"POS","noSubs","noPerson","restaurant","fastfood",-5,762
"243",2017-03-14,"FPP","noSubs","mother","noCat","noSubCat",187,949
"244",2017-03-14,"POS","noSubs","noPerson","shopping","groceries",-25,924
"245",2017-03-14,"POS","noSubs","noPerson","transport","subway",-8,916
"246",2017-03-14,"POS","noSubs","noPerson","shopping","groceries",-19,897
"247",2017-03-15,"ATM","noSubs","noPerson","noCat","noSubCat",-50,847
"248",2017-03-15,"FPP","noSubs","mother","noCat","noSubCat",128,975
"249",2017-03-15,"POS","noSubs","noPerson","transport","uber",-18,957
"250",2017-03-15,"POS","noSubs","noPerson","shopping","groceries",-10,947
"251",2017-03-15,"POS","noSubs","noPerson","restaurant","drinks",-24,923
"252",2017-03-16,"POS","noSubs","noPerson","restaurant","drinks",-25,898
"253",2017-03-16,"POS","noSubs","noPerson","travelling","car",-25,873
"254",2017-03-16,"POS","noSubs","noPerson","restaurant","fastfood",-10,863
"255",2017-03-17,"ATM","noSubs","noPerson","noCat","noSubCat",-38,825
"256",2017-03-17,"FPP","noSubs","father","noCat","noSubCat",118,943
"257",2017-03-17,"POS","noSubs","noPerson","restaurant","fastfood",-6,937
"258",2017-03-18,"ATM","noSubs","noPerson","noCat","noSubCat",-23,914
"259",2017-03-18,"FPN","noSubs","sergi","noCat","noSubCat",-29,885
"260",2017-03-18,"POS","noSubs","noPerson","restaurant","fastfood",-7,878
"261",2017-03-18,"POS","noSubs","noPerson","restaurant","drinks",-16,862
"262",2017-03-19,"FPN","noSubs","sergi","noCat","noSubCat",-25,837
"263",2017-03-19,"POS","noSubs","noPerson","shopping","groceries",-26,811
"264",2017-03-19,"POS","noSubs","noPerson","shopping","groceries",-29,782
"265",2017-03-19,"POS","noSubs","noPerson","restaurant","drinks",-30,752
"266",2017-03-20,"FPN","noSubs","sergi","noCat","noSubCat",-21,731
"267",2017-03-20,"POS","noSubs","noPerson","travelling","flights",-167,564
"268",2017-03-20,"POS","noSubs","noPerson","restaurant","fastfood",-8,556
"269",2017-03-20,"POS","noSubs","noPerson","restaurant","drinks",-26,530
"270",2017-03-20,"POS","noSubs","noPerson","shopping","clothes",-66,464
"271",2017-03-21,"FPN","noSubs","sergi","noCat","noSubCat",-23,441
"272",2017-03-21,"POS","noSubs","noPerson","shopping","groceries",-12,429
"273",2017-03-21,"POS","noSubs","noPerson","restaurant","drinks",-22,407
"274",2017-03-22,"ATM","noSubs","noPerson","noCat","noSubCat",-22,385
"275",2017-03-22,"FPN","noSubs","sergi","noCat","noSubCat",-22,363
"276",2017-03-22,"POS","noSubs","noPerson","restaurant","fastfood",-8,355
"277",2017-03-22,"POS","noSubs","noPerson","shopping","healthcare",-13,342
"278",2017-03-22,"POS","noSubs","noPerson","transport","subway",-3,339
"279",2017-03-23,"FPN","noSubs","sergi","noCat","noSubCat",-28,311
"280",2017-03-23,"POS","noSubs","noPerson","travelling","train",-26,285
"281",2017-03-23,"POS","noSubs","noPerson","restaurant","fastfood",-7,278
"282",2017-03-23,"POS","noSubs","noPerson","restaurant","drinks",-29,249
"283",2017-03-24,"POS","noSubs","noPerson","travelling","train",-30,219
"284",2017-03-24,"POS","noSubs","noPerson","restaurant","healthyfood",-20,199
"285",2017-03-24,"POS","noSubs","noPerson","transport","bus",-6,193
"286",2017-03-25,"POS","noSubs","noPerson","shopping","groceries",-26,167
"287",2017-03-25,"POS","noSubs","noPerson","shopping","groceries",-26,141
"288",2017-03-25,"POS","noSubs","noPerson","restaurant","fastfood",-8,133
"289",2017-03-25,"POS","noSubs","noPerson","transport","bus",-8,125
"290",2017-03-26,"ATM","noSubs","noPerson","noCat","noSubCat",-43,82
"291",2017-03-26,"FPN","noSubs","biel","noCat","noSubCat",-21,61
"292",2017-03-26,"POS","noSubs","noPerson","travelling","train",-13,48
"293",2017-03-27,"FPN","noSubs","sergi","noCat","noSubCat",-27,21
"294",2017-03-27,"POS","noSubs","noPerson","restaurant","fastfood",-9,12
"295",2017-03-27,"POS","noSubs","noPerson","restaurant","fastfood",-8,4
"296",2017-03-28,"FPN","noSubs","biel","noCat","noSubCat",-33,-29
"297",2017-03-28,"POS","noSubs","noPerson","shopping","groceries",-28,-57
"298",2017-03-28,"POS","noSubs","noPerson","restaurant","healthyfood",-29,-86
"299",2017-03-28,"POS","noSubs","noPerson","restaurant","fastfood",-10,-96
"300",2017-03-28,"POS","noSubs","noPerson","transport","subway",-7,-103
"301",2017-03-28,"POS","noSubs","noPerson","restaurant","healthyfood",-24,-127
"302",2017-03-28,"POS","noSubs","noPerson","restaurant","drinks",-11,-138
"303",2017-03-29,"POS","noSubs","noPerson","shopping","groceries",-29,-167
"304",2017-03-29,"POS","noSubs","noPerson","restaurant","healthyfood",-30,-197
"305",2017-03-29,"POS","noSubs","noPerson","shopping","groceries",-24,-221
"306",2017-03-29,"POS","noSubs","noPerson","restaurant","fastfood",-9,-230
"307",2017-03-30,"ATM","noSubs","noPerson","noCat","noSubCat",-40,-270
"308",2017-03-30,"ATM","noSubs","noPerson","noCat","noSubCat",-36,-306
"309",2017-03-30,"POS","noSubs","noPerson","restaurant","drinks",-11,-317
"310",2017-03-30,"POS","noSubs","noPerson","shopping","clothes",-55,-372
"311",2017-03-31,"BACS","noSubs","noPerson","noCat","noSubCat",2000,1628
"312",2017-03-31,"DD","amazon","noPerson","noCat","noSubCat",-4,1624
"313",2017-03-31,"DD","gym","noPerson","noCat","noSubCat",-40,1584
"314",2017-03-31,"DD","netflix","noPerson","noCat","noSubCat",-8,1576
"315",2017-03-31,"DD","spotify","noPerson","noCat","noSubCat",-10,1566
"316",2017-03-31,"FPN","noSubs","biel","noCat","noSubCat",-21,1545
"317",2017-03-31,"POS","noSubs","noPerson","restaurant","fastfood",-5,1540
"318",2017-03-31,"POS","noSubs","noPerson","restaurant","drinks",-30,1510
"319",2017-04-01,"FPN","noSubs","biel","noCat","noSubCat",-33,1477
"320",2017-04-01,"FPN","noSubs","biel","noCat","noSubCat",-26,1451
"321",2017-04-01,"POS","noSubs","noPerson","shopping","clothes",-28,1423
"322",2017-04-01,"POS","noSubs","noPerson","shopping","groceries",-16,1407
"323",2017-04-02,"POS","noSubs","noPerson","shopping","groceries",-11,1396
"324",2017-04-02,"POS","noSubs","noPerson","restaurant","drinks",-8,1388
"325",2017-04-03,"FPN","noSubs","sergi","noCat","noSubCat",-40,1348
"326",2017-04-03,"POS","noSubs","noPerson","shopping","healthcare",-13,1335
"327",2017-04-03,"POS","noSubs","noPerson","shopping","clothes",-68,1267
"328",2017-04-03,"POS","noSubs","noPerson","shopping","groceries",-19,1248
"329",2017-04-03,"POS","noSubs","noPerson","restaurant","fastfood",-8,1240
"330",2017-04-03,"POS","noSubs","noPerson","shopping","clothes",-52,1188
"331",2017-04-03,"POS","noSubs","noPerson","shopping","groceries",-21,1167
"332",2017-04-04,"FPP","noSubs","father","noCat","noSubCat",186,1353
"333",2017-04-04,"POS","noSubs","noPerson","shopping","groceries",-23,1330
"334",2017-04-04,"POS","noSubs","noPerson","shopping","groceries",-18,1312
"335",2017-04-04,"POS","noSubs","noPerson","shopping","clothes",-47,1265
"336",2017-04-04,"POS","noSubs","noPerson","shopping","groceries",-24,1241
"337",2017-04-05,"FPP","noSubs","mother","noCat","noSubCat",155,1396
"338",2017-04-05,"POS","noSubs","noPerson","travelling","flights",-151,1245
"339",2017-04-05,"POS","noSubs","noPerson","restaurant","fastfood",-5,1240
"340",2017-04-05,"POS","noSubs","noPerson","restaurant","healthyfood",-23,1217
"341",2017-04-06,"POS","noSubs","noPerson","restaurant","healthyfood",-28,1189
"342",2017-04-06,"POS","noSubs","noPerson","shopping","groceries",-10,1179
"343",2017-04-06,"POS","noSubs","noPerson","shopping","groceries",-22,1157
"344",2017-04-06,"POS","noSubs","noPerson","travelling","flights",-95,1062
"345",2017-04-07,"ATM","noSubs","noPerson","noCat","noSubCat",-22,1040
"346",2017-04-07,"POS","noSubs","noPerson","restaurant","fastfood",-7,1033
"347",2017-04-07,"POS","noSubs","noPerson","transport","subway",-8,1025
"348",2017-04-08,"ATM","noSubs","noPerson","noCat","noSubCat",-50,975
"349",2017-04-08,"POS","noSubs","noPerson","restaurant","drinks",-25,950
"350",2017-04-09,"FPN","noSubs","biel","noCat","noSubCat",-39,911
"351",2017-04-09,"FPP","noSubs","mother","noCat","noSubCat",118,1029
"352",2017-04-09,"POS","noSubs","noPerson","travelling","train",-29,1000
"353",2017-04-09,"POS","noSubs","noPerson","shopping","groceries",-20,980
"354",2017-04-09,"POS","noSubs","noPerson","travelling","flights",-175,805
"355",2017-04-10,"FPN","noSubs","biel","noCat","noSubCat",-30,775
"356",2017-04-10,"POS","noSubs","noPerson","restaurant","fastfood",-10,765
"357",2017-04-10,"POS","noSubs","noPerson","restaurant","fastfood",-10,755
"358",2017-04-10,"POS","noSubs","noPerson","shopping","healthcare",-12,743
"359",2017-04-10,"POS","noSubs","noPerson","travelling","train",-13,730
"360",2017-04-11,"POS","noSubs","noPerson","shopping","groceries",-19,711
"361",2017-04-12,"POS","noSubs","noPerson","restaurant","fastfood",-7,704
"362",2017-04-12,"POS","noSubs","noPerson","shopping","groceries",-26,678
"363",2017-04-13,"FPN","noSubs","sergi","noCat","noSubCat",-30,648
"364",2017-04-13,"POS","noSubs","noPerson","shopping","groceries",-18,630
"365",2017-04-14,"FPN","noSubs","sergi","noCat","noSubCat",-22,608
"366",2017-04-14,"POS","noSubs","noPerson","shopping","groceries",-25,583
"367",2017-04-14,"POS","noSubs","noPerson","restaurant","fastfood",-9,574
"368",2017-04-15,"FPN","noSubs","sergi","noCat","noSubCat",-28,546
"369",2017-04-15,"POS","noSubs","noPerson","transport","uber",-12,534
"370",2017-04-16,"FPN","noSubs","sergi","noCat","noSubCat",-20,514
"371",2017-04-16,"POS","noSubs","noPerson","restaurant","healthyfood",-20,494
"372",2017-04-16,"POS","noSubs","noPerson","restaurant","fastfood",-7,487
"373",2017-04-16,"POS","noSubs","noPerson","shopping","groceries",-12,475
"374",2017-04-16,"POS","noSubs","noPerson","shopping","groceries",-29,446
"375",2017-04-17,"FPP","noSubs","mother","noCat","noSubCat",131,577
"376",2017-04-17,"POS","noSubs","noPerson","transport","uber",-14,563
"377",2017-04-17,"POS","noSubs","noPerson","shopping","groceries",-30,533
"378",2017-04-17,"POS","noSubs","noPerson","shopping","groceries",-13,520
"379",2017-04-17,"POS","noSubs","noPerson","restaurant","drinks",-19,501
"380",2017-04-17,"POS","noSubs","noPerson","restaurant","drinks",-7,494
"381",2017-04-18,"POS","noSubs","noPerson","transport","uber",-18,476
"382",2017-04-18,"POS","noSubs","noPerson","restaurant","fastfood",-7,469
"383",2017-04-18,"POS","noSubs","noPerson","restaurant","drinks",-16,453
"384",2017-04-18,"POS","noSubs","noPerson","restaurant","fastfood",-10,443
"385",2017-04-19,"POS","noSubs","noPerson","travelling","flights",-186,257
"386",2017-04-19,"POS","noSubs","noPerson","shopping","groceries",-11,246
"387",2017-04-19,"POS","noSubs","noPerson","travelling","flights",-197,49
"388",2017-04-21,"ATM","noSubs","noPerson","noCat","noSubCat",-37,12
"389",2017-04-21,"ATM","noSubs","noPerson","noCat","noSubCat",-22,-10
"390",2017-04-21,"ATM","noSubs","noPerson","noCat","noSubCat",-41,-51
"391",2017-04-21,"POS","noSubs","noPerson","shopping","groceries",-24,-75
"392",2017-04-22,"POS","noSubs","noPerson","travelling","car",-23,-98
"393",2017-04-22,"POS","noSubs","noPerson","shopping","healthcare",-14,-112
"394",2017-04-23,"FPN","noSubs","biel","noCat","noSubCat",-29,-141
"395",2017-04-23,"FPP","noSubs","mother","noCat","noSubCat",175,34
"396",2017-04-23,"FPP","noSubs","mother","noCat","noSubCat",132,166
"397",2017-04-23,"POS","noSubs","noPerson","restaurant","fastfood",-8,158
"398",2017-04-24,"POS","noSubs","noPerson","shopping","groceries",-21,137
"399",2017-04-24,"POS","noSubs","noPerson","shopping","clothes",-24,113
"400",2017-04-24,"POS","noSubs","noPerson","shopping","groceries",-14,99
"401",2017-04-24,"POS","noSubs","noPerson","shopping","groceries",-17,82
"402",2017-04-24,"POS","noSubs","noPerson","shopping","groceries",-17,65
"403",2017-04-24,"POS","noSubs","noPerson","restaurant","fastfood",-10,55
"404",2017-04-25,"POS","noSubs","noPerson","shopping","groceries",-25,30
"405",2017-04-25,"POS","noSubs","noPerson","travelling","train",-13,17
"406",2017-04-26,"FPN","noSubs","biel","noCat","noSubCat",-36,-19
"407",2017-04-26,"FPP","noSubs","father","noCat","noSubCat",112,93
"408",2017-04-26,"POS","noSubs","noPerson","restaurant","drinks",-30,63
"409",2017-04-26,"POS","noSubs","noPerson","shopping","groceries",-15,48
"410",2017-04-26,"POS","noSubs","noPerson","restaurant","fastfood",-8,40
"411",2017-04-26,"POS","noSubs","noPerson","shopping","clothes",-31,9
"412",2017-04-27,"ATM","noSubs","noPerson","noCat","noSubCat",-45,-36
"413",2017-04-27,"FPN","noSubs","biel","noCat","noSubCat",-38,-74
"414",2017-04-27,"POS","noSubs","noPerson","travelling","train",-16,-90
"415",2017-04-28,"ATM","noSubs","noPerson","noCat","noSubCat",-50,-140
"416",2017-04-28,"POS","noSubs","noPerson","travelling","train",-17,-157
"417",2017-04-28,"POS","noSubs","noPerson","restaurant","drinks",-9,-166
"418",2017-04-28,"POS","noSubs","noPerson","restaurant","healthyfood",-22,-188
"419",2017-04-29,"ATM","noSubs","noPerson","noCat","noSubCat",-46,-234
"420",2017-04-29,"FPN","noSubs","biel","noCat","noSubCat",-28,-262
"421",2017-04-29,"POS","noSubs","noPerson","restaurant","fastfood",-5,-267
"422",2017-04-29,"POS","noSubs","noPerson","restaurant","fastfood",-5,-272
"423",2017-04-29,"POS","noSubs","noPerson","restaurant","fastfood",-9,-281
"424",2017-04-30,"BACS","noSubs","noPerson","noCat","noSubCat",2000,1719
"425",2017-04-30,"DD","amazon","noPerson","noCat","noSubCat",-4,1715
"426",2017-04-30,"DD","gym","noPerson","noCat","noSubCat",-40,1675
"427",2017-04-30,"DD","netflix","noPerson","noCat","noSubCat",-8,1667
"428",2017-04-30,"DD","spotify","noPerson","noCat","noSubCat",-10,1657
"429",2017-04-30,"POS","noSubs","noPerson","transport","bus",-8,1649
"430",2017-05-01,"ATM","noSubs","noPerson","noCat","noSubCat",-24,1625
"431",2017-05-01,"ATM","noSubs","noPerson","noCat","noSubCat",-30,1595
"432",2017-05-01,"FPN","noSubs","biel","noCat","noSubCat",-40,1555
"433",2017-05-01,"POS","noSubs","noPerson","shopping","healthcare",-10,1545
"434",2017-05-01,"POS","noSubs","noPerson","restaurant","healthyfood",-27,1518
"435",2017-05-02,"FPP","noSubs","father","noCat","noSubCat",157,1675
"436",2017-05-02,"POS","noSubs","noPerson","restaurant","fastfood",-6,1669
"437",2017-05-02,"POS","noSubs","noPerson","transport","bus",-5,1664
"438",2017-05-02,"POS","noSubs","noPerson","restaurant","drinks",-15,1649
"439",2017-05-02,"POS","noSubs","noPerson","shopping","groceries",-20,1629
"440",2017-05-02,"POS","noSubs","noPerson","shopping","groceries",-29,1600
"441",2017-05-03,"POS","noSubs","noPerson","transport","subway",-7,1593
"442",2017-05-03,"POS","noSubs","noPerson","shopping","groceries",-24,1569
"443",2017-05-03,"POS","noSubs","noPerson","restaurant","healthyfood",-27,1542
"444",2017-05-04,"POS","noSubs","noPerson","restaurant","fastfood",-9,1533
"445",2017-05-04,"POS","noSubs","noPerson","shopping","healthcare",-18,1515
"446",2017-05-04,"POS","noSubs","noPerson","restaurant","healthyfood",-29,1486
"447",2017-05-05,"ATM","noSubs","noPerson","noCat","noSubCat",-39,1447
"448",2017-05-05,"FPP","noSubs","father","noCat","noSubCat",100,1547
"449",2017-05-05,"POS","noSubs","noPerson","restaurant","fastfood",-9,1538
"450",2017-05-05,"POS","noSubs","noPerson","shopping","clothes",-74,1464
"451",2017-05-06,"FPN","noSubs","sergi","noCat","noSubCat",-39,1425
"452",2017-05-06,"POS","noSubs","noPerson","travelling","train",-24,1401
"453",2017-05-06,"POS","noSubs","noPerson","shopping","groceries",-17,1384
"454",2017-05-07,"POS","noSubs","noPerson","shopping","groceries",-26,1358
"455",2017-05-07,"POS","noSubs","noPerson","restaurant","healthyfood",-27,1331
"456",2017-05-07,"POS","noSubs","noPerson","shopping","healthcare",-16,1315
"457",2017-05-08,"FPN","noSubs","biel","noCat","noSubCat",-27,1288
"458",2017-05-08,"FPN","noSubs","sergi","noCat","noSubCat",-22,1266
"459",2017-05-08,"POS","noSubs","noPerson","restaurant","drinks",-8,1258
"460",2017-05-09,"FPN","noSubs","biel","noCat","noSubCat",-35,1223
"461",2017-05-10,"POS","noSubs","noPerson","travelling","flights",-116,1107
"462",2017-05-11,"FPN","noSubs","sergi","noCat","noSubCat",-21,1086
"463",2017-05-11,"POS","noSubs","noPerson","restaurant","healthyfood",-26,1060
"464",2017-05-12,"POS","noSubs","noPerson","restaurant","fastfood",-9,1051
"465",2017-05-12,"POS","noSubs","noPerson","shopping","groceries",-29,1022
"466",2017-05-13,"POS","noSubs","noPerson","shopping","groceries",-11,1011
"467",2017-05-14,"POS","noSubs","noPerson","restaurant","healthyfood",-22,989
"468",2017-05-14,"POS","noSubs","noPerson","restaurant","drinks",-30,959
"469",2017-05-14,"POS","noSubs","noPerson","shopping","groceries",-20,939
"470",2017-05-15,"ATM","noSubs","noPerson","noCat","noSubCat",-46,893
"471",2017-05-15,"POS","noSubs","noPerson","travelling","car",-25,868
"472",2017-05-15,"POS","noSubs","noPerson","restaurant","fastfood",-5,863
"473",2017-05-16,"ATM","noSubs","noPerson","noCat","noSubCat",-36,827
"474",2017-05-16,"POS","noSubs","noPerson","restaurant","fastfood",-9,818
"475",2017-05-16,"POS","noSubs","noPerson","shopping","groceries",-19,799
"476",2017-05-16,"POS","noSubs","noPerson","shopping","healthcare",-17,782
"477",2017-05-17,"ATM","noSubs","noPerson","noCat","noSubCat",-26,756
"478",2017-05-17,"ATM","noSubs","noPerson","noCat","noSubCat",-29,727
"479",2017-05-17,"POS","noSubs","noPerson","restaurant","healthyfood",-28,699
"480",2017-05-17,"POS","noSubs","noPerson","shopping","groceries",-13,686
"481",2017-05-17,"POS","noSubs","noPerson","shopping","groceries",-19,667
"482",2017-05-17,"POS","noSubs","noPerson","restaurant","healthyfood",-20,647
"483",2017-05-17,"POS","noSubs","noPerson","shopping","groceries",-11,636
"484",2017-05-17,"POS","noSubs","noPerson","shopping","groceries",-15,621
"485",2017-05-18,"POS","noSubs","noPerson","travelling","train",-15,606
"486",2017-05-18,"POS","noSubs","noPerson","restaurant","drinks",-7,599
"487",2017-05-18,"POS","noSubs","noPerson","shopping","groceries",-19,580
"488",2017-05-19,"ATM","noSubs","noPerson","noCat","noSubCat",-45,535
"489",2017-05-19,"POS","noSubs","noPerson","transport","subway",-2,533
"490",2017-05-19,"POS","noSubs","noPerson","transport","uber",-10,523
"491",2017-05-19,"POS","noSubs","noPerson","travelling","train",-14,509
"492",2017-05-19,"POS","noSubs","noPerson","shopping","groceries",-11,498
"493",2017-05-19,"POS","noSubs","noPerson","shopping","healthcare",-15,483
"494",2017-05-19,"POS","noSubs","noPerson","shopping","groceries",-22,461
"495",2017-05-19,"POS","noSubs","noPerson","shopping","groceries",-22,439
"496",2017-05-20,"POS","noSubs","noPerson","travelling","flights",-188,251
"497",2017-05-20,"POS","noSubs","noPerson","restaurant","healthyfood",-25,226
"498",2017-05-20,"POS","noSubs","noPerson","restaurant","fastfood",-7,219
"499",2017-05-21,"ATM","noSubs","noPerson","noCat","noSubCat",-35,184
"500",2017-05-21,"FPN","noSubs","biel","noCat","noSubCat",-23,161
"501",2017-05-21,"FPN","noSubs","biel","noCat","noSubCat",-34,127
"502",2017-05-21,"POS","noSubs","noPerson","restaurant","fastfood",-5,122
"503",2017-05-21,"POS","noSubs","noPerson","shopping","healthcare",-14,108
"504",2017-05-21,"POS","noSubs","noPerson","transport","subway",-2,106
"505",2017-05-21,"POS","noSubs","noPerson","travelling","train",-17,89
"506",2017-05-22,"POS","noSubs","noPerson","transport","uber",-19,70
"507",2017-05-22,"POS","noSubs","noPerson","shopping","groceries",-22,48
"508",2017-05-22,"POS","noSubs","noPerson","travelling","flights",-161,-113
"509",2017-05-22,"POS","noSubs","noPerson","shopping","clothes",-25,-138
"510",2017-05-23,"POS","noSubs","noPerson","shopping","groceries",-20,-158
"511",2017-05-23,"POS","noSubs","noPerson","restaurant","drinks",-23,-181
"512",2017-05-23,"POS","noSubs","noPerson","restaurant","healthyfood",-24,-205
"513",2017-05-23,"POS","noSubs","noPerson","restaurant","fastfood",-10,-215
"514",2017-05-24,"POS","noSubs","noPerson","restaurant","healthyfood",-22,-237
"515",2017-05-25,"POS","noSubs","noPerson","shopping","groceries",-26,-263
"516",2017-05-25,"POS","noSubs","noPerson","travelling","car",-27,-290
"517",2017-05-25,"POS","noSubs","noPerson","shopping","groceries",-20,-310
"518",2017-05-26,"FPN","noSubs","sergi","noCat","noSubCat",-23,-333
"519",2017-05-26,"POS","noSubs","noPerson","restaurant","fastfood",-7,-340
"520",2017-05-26,"POS","noSubs","noPerson","restaurant","fastfood",-7,-347
"521",2017-05-26,"POS","noSubs","noPerson","transport","uber",-15,-362
"522",2017-05-27,"POS","noSubs","noPerson","shopping","groceries",-21,-383
"523",2017-05-28,"FPN","noSubs","biel","noCat","noSubCat",-40,-423
"524",2017-05-28,"POS","noSubs","noPerson","restaurant","healthyfood",-21,-444
"525",2017-05-28,"POS","noSubs","noPerson","restaurant","drinks",-6,-450
"526",2017-05-28,"POS","noSubs","noPerson","restaurant","healthyfood",-28,-478
"527",2017-05-28,"POS","noSubs","noPerson","shopping","clothes",-64,-542
"528",2017-05-29,"FPN","noSubs","sergi","noCat","noSubCat",-25,-567
"529",2017-05-29,"POS","noSubs","noPerson","shopping","groceries",-27,-594
"530",2017-05-29,"POS","noSubs","noPerson","restaurant","healthyfood",-20,-614
"531",2017-05-29,"POS","noSubs","noPerson","restaurant","drinks",-19,-633
"532",2017-05-29,"POS","noSubs","noPerson","shopping","clothes",-61,-694
"533",2017-05-29,"POS","noSubs","noPerson","restaurant","drinks",-8,-702
"534",2017-05-29,"POS","noSubs","noPerson","shopping","groceries",-18,-720
"535",2017-05-30,"BACS","noSubs","noPerson","noCat","noSubCat",2000,1280
"536",2017-05-30,"DD","amazon","noPerson","noCat","noSubCat",-4,1276
"537",2017-05-30,"DD","gym","noPerson","noCat","noSubCat",-40,1236
"538",2017-05-30,"DD","netflix","noPerson","noCat","noSubCat",-8,1228
"539",2017-05-30,"DD","spotify","noPerson","noCat","noSubCat",-10,1218
"540",2017-05-30,"FPN","noSubs","biel","noCat","noSubCat",-33,1185
"541",2017-05-30,"POS","noSubs","noPerson","restaurant","fastfood",-10,1175
"542",2017-05-30,"POS","noSubs","noPerson","restaurant","drinks",-14,1161
"543",2017-05-30,"POS","noSubs","noPerson","restaurant","drinks",-5,1156
"544",2017-05-30,"POS","noSubs","noPerson","shopping","groceries",-14,1142
"545",2017-05-31,"POS","noSubs","noPerson","shopping","groceries",-25,1117
"546",2017-05-31,"POS","noSubs","noPerson","restaurant","healthyfood",-30,1087
"547",2017-06-01,"FPN","noSubs","biel","noCat","noSubCat",-22,1065
"548",2017-06-01,"POS","noSubs","noPerson","restaurant","drinks",-22,1043
"549",2017-06-01,"POS","noSubs","noPerson","shopping","groceries",-23,1020
"550",2017-06-01,"POS","noSubs","noPerson","restaurant","fastfood",-7,1013
"551",2017-06-01,"POS","noSubs","noPerson","restaurant","fastfood",-6,1007
"552",2017-06-02,"POS","noSubs","noPerson","shopping","groceries",-28,979
"553",2017-06-02,"POS","noSubs","noPerson","restaurant","drinks",-12,967
"554",2017-06-02,"POS","noSubs","noPerson","restaurant","fastfood",-8,959
"555",2017-06-02,"POS","noSubs","noPerson","shopping","groceries",-11,948
"556",2017-06-03,"FPP","noSubs","mother","noCat","noSubCat",101,1049
"557",2017-06-03,"POS","noSubs","noPerson","restaurant","fastfood",-7,1042
"558",2017-06-03,"POS","noSubs","noPerson","shopping","healthcare",-10,1032
"559",2017-06-03,"POS","noSubs","noPerson","restaurant","drinks",-30,1002
"560",2017-06-04,"FPP","noSubs","father","noCat","noSubCat",155,1157
"561",2017-06-04,"POS","noSubs","noPerson","restaurant","healthyfood",-27,1130
"562",2017-06-04,"POS","noSubs","noPerson","shopping","clothes",-66,1064
"563",2017-06-05,"ATM","noSubs","noPerson","noCat","noSubCat",-35,1029
"564",2017-06-05,"FPN","noSubs","sergi","noCat","noSubCat",-30,999
"565",2017-06-05,"FPN","noSubs","biel","noCat","noSubCat",-23,976
"566",2017-06-05,"POS","noSubs","noPerson","shopping","healthcare",-19,957
"567",2017-06-05,"POS","noSubs","noPerson","restaurant","fastfood",-5,952
"568",2017-06-05,"POS","noSubs","noPerson","shopping","groceries",-18,934
"569",2017-06-05,"POS","noSubs","noPerson","shopping","groceries",-29,905
"570",2017-06-06,"POS","noSubs","noPerson","shopping","clothes",-65,840
"571",2017-06-07,"POS","noSubs","noPerson","shopping","groceries",-25,815
"572",2017-06-07,"POS","noSubs","noPerson","restaurant","fastfood",-8,807
"573",2017-06-08,"ATM","noSubs","noPerson","noCat","noSubCat",-44,763
"574",2017-06-08,"FPP","noSubs","mother","noCat","noSubCat",127,890
"575",2017-06-08,"POS","noSubs","noPerson","restaurant","healthyfood",-23,867
"576",2017-06-08,"POS","noSubs","noPerson","restaurant","healthyfood",-28,839
"577",2017-06-08,"POS","noSubs","noPerson","restaurant","drinks",-28,811
"578",2017-06-08,"POS","noSubs","noPerson","restaurant","fastfood",-7,804
"579",2017-06-09,"ATM","noSubs","noPerson","noCat","noSubCat",-45,759
"580",2017-06-09,"POS","noSubs","noPerson","shopping","groceries",-12,747
"581",2017-06-09,"POS","noSubs","noPerson","restaurant","healthyfood",-28,719
"582",2017-06-09,"POS","noSubs","noPerson","restaurant","healthyfood",-29,690
"583",2017-06-10,"POS","noSubs","noPerson","restaurant","fastfood",-5,685
"584",2017-06-11,"FPN","noSubs","biel","noCat","noSubCat",-26,659
"585",2017-06-11,"FPP","noSubs","mother","noCat","noSubCat",193,852
"586",2017-06-11,"POS","noSubs","noPerson","shopping","groceries",-17,835
"587",2017-06-12,"ATM","noSubs","noPerson","noCat","noSubCat",-34,801
"588",2017-06-12,"POS","noSubs","noPerson","shopping","groceries",-26,775
"589",2017-06-12,"POS","noSubs","noPerson","shopping","groceries",-20,755
"590",2017-06-12,"POS","noSubs","noPerson","restaurant","fastfood",-5,750
"591",2017-06-13,"POS","noSubs","noPerson","restaurant","drinks",-26,724
"592",2017-06-13,"POS","noSubs","noPerson","transport","subway",-5,719
"593",2017-06-13,"POS","noSubs","noPerson","restaurant","fastfood",-7,712
"594",2017-06-13,"POS","noSubs","noPerson","travelling","car",-12,700
"595",2017-06-13,"POS","noSubs","noPerson","shopping","groceries",-11,689
"596",2017-06-14,"ATM","noSubs","noPerson","noCat","noSubCat",-40,649
"597",2017-06-14,"FPP","noSubs","mother","noCat","noSubCat",131,780
"598",2017-06-14,"POS","noSubs","noPerson","transport","subway",-8,772
"599",2017-06-14,"POS","noSubs","noPerson","shopping","groceries",-17,755
"600",2017-06-15,"FPP","noSubs","father","noCat","noSubCat",127,882
"601",2017-06-15,"POS","noSubs","noPerson","shopping","groceries",-18,864
"602",2017-06-16,"POS","noSubs","noPerson","restaurant","fastfood",-7,857
"603",2017-06-16,"POS","noSubs","noPerson","restaurant","healthyfood",-21,836
"604",2017-06-16,"POS","noSubs","noPerson","transport","uber",-19,817
"605",2017-06-16,"POS","noSubs","noPerson","restaurant","fastfood",-9,808
"606",2017-06-16,"POS","noSubs","noPerson","restaurant","fastfood",-9,799
"607",2017-06-17,"POS","noSubs","noPerson","restaurant","fastfood",-8,791
"608",2017-06-17,"POS","noSubs","noPerson","restaurant","drinks",-16,775
"609",2017-06-18,"ATM","noSubs","noPerson","noCat","noSubCat",-46,729
"610",2017-06-18,"FPN","noSubs","biel","noCat","noSubCat",-35,694
"611",2017-06-18,"POS","noSubs","noPerson","restaurant","drinks",-15,679
"612",2017-06-18,"POS","noSubs","noPerson","shopping","clothes",-30,649
"613",2017-06-18,"POS","noSubs","noPerson","restaurant","healthyfood",-27,622
"614",2017-06-18,"POS","noSubs","noPerson","transport","bus",-2,620
"615",2017-06-18,"POS","noSubs","noPerson","travelling","train",-10,610
"616",2017-06-19,"FPN","noSubs","sergi","noCat","noSubCat",-25,585
"617",2017-06-19,"FPN","noSubs","sergi","noCat","noSubCat",-37,548
"618",2017-06-19,"FPN","noSubs","sergi","noCat","noSubCat",-29,519
"619",2017-06-19,"POS","noSubs","noPerson","shopping","groceries",-22,497
"620",2017-06-20,"ATM","noSubs","noPerson","noCat","noSubCat",-50,447
"621",2017-06-20,"FPN","noSubs","biel","noCat","noSubCat",-39,408
"622",2017-06-20,"POS","noSubs","noPerson","restaurant","healthyfood",-21,387
"623",2017-06-20,"POS","noSubs","noPerson","shopping","groceries",-18,369
"624",2017-06-20,"POS","noSubs","noPerson","restaurant","healthyfood",-20,349
"625",2017-06-20,"POS","noSubs","noPerson","shopping","groceries",-28,321
"626",2017-06-21,"FPP","noSubs","mother","noCat","noSubCat",106,427
"627",2017-06-21,"POS","noSubs","noPerson","shopping","groceries",-17,410
"628",2017-06-21,"POS","noSubs","noPerson","shopping","groceries",-11,399
"629",2017-06-21,"POS","noSubs","noPerson","restaurant","fastfood",-5,394
"630",2017-06-22,"FPN","noSubs","biel","noCat","noSubCat",-38,356
"631",2017-06-22,"FPP","noSubs","mother","noCat","noSubCat",154,510
"632",2017-06-22,"FPP","noSubs","father","noCat","noSubCat",198,708
"633",2017-06-22,"POS","noSubs","noPerson","transport","uber",-19,689
"634",2017-06-22,"POS","noSubs","noPerson","shopping","clothes",-56,633
"635",2017-06-22,"POS","noSubs","noPerson","shopping","healthcare",-12,621
"636",2017-06-22,"POS","noSubs","noPerson","restaurant","drinks",-23,598
"637",2017-06-22,"POS","noSubs","noPerson","shopping","groceries",-19,579
"638",2017-06-22,"POS","noSubs","noPerson","transport","bus",-5,574
"639",2017-06-22,"POS","noSubs","noPerson","transport","uber",-18,556
"640",2017-06-23,"FPN","noSubs","sergi","noCat","noSubCat",-34,522
"641",2017-06-23,"POS","noSubs","noPerson","restaurant","healthyfood",-26,496
"642",2017-06-24,"FPP","noSubs","father","noCat","noSubCat",180,676
"643",2017-06-24,"POS","noSubs","noPerson","restaurant","fastfood",-6,670
"644",2017-06-24,"POS","noSubs","noPerson","restaurant","drinks",-30,640
"645",2017-06-24,"POS","noSubs","noPerson","shopping","groceries",-17,623
"646",2017-06-25,"FPN","noSubs","sergi","noCat","noSubCat",-37,586
"647",2017-06-25,"POS","noSubs","noPerson","shopping","groceries",-20,566
"648",2017-06-25,"POS","noSubs","noPerson","restaurant","drinks",-24,542
"649",2017-06-25,"POS","noSubs","noPerson","transport","subway",-6,536
"650",2017-06-26,"FPN","noSubs","biel","noCat","noSubCat",-23,513
"651",2017-06-26,"POS","noSubs","noPerson","shopping","groceries",-11,502
"652",2017-06-26,"POS","noSubs","noPerson","shopping","groceries",-27,475
"653",2017-06-27,"POS","noSubs","noPerson","restaurant","drinks",-25,450
"654",2017-06-27,"POS","noSubs","noPerson","travelling","train",-20,430
"655",2017-06-28,"POS","noSubs","noPerson","shopping","healthcare",-15,415
"656",2017-06-28,"POS","noSubs","noPerson","shopping","healthcare",-12,403
"657",2017-06-28,"POS","noSubs","noPerson","shopping","groceries",-30,373
"658",2017-06-29,"FPN","noSubs","sergi","noCat","noSubCat",-35,338
"659",2017-06-29,"POS","noSubs","noPerson","restaurant","fastfood",-7,331
"660",2017-06-29,"POS","noSubs","noPerson","shopping","healthcare",-11,320
"661",2017-06-29,"POS","noSubs","noPerson","shopping","groceries",-10,310
"662",2017-06-29,"POS","noSubs","noPerson","shopping","healthcare",-15,295
"663",2017-06-29,"POS","noSubs","noPerson","shopping","groceries",-29,266
"664",2017-06-30,"BACS","noSubs","noPerson","noCat","noSubCat",2000,2266
"665",2017-06-30,"DD","amazon","noPerson","noCat","noSubCat",-4,2262
"666",2017-06-30,"DD","gym","noPerson","noCat","noSubCat",-40,2222
"667",2017-06-30,"DD","netflix","noPerson","noCat","noSubCat",-8,2214
"668",2017-06-30,"DD","spotify","noPerson","noCat","noSubCat",-10,2204
"669",2017-06-30,"FPN","noSubs","biel","noCat","noSubCat",-35,2169
"670",2017-06-30,"POS","noSubs","noPerson","restaurant","fastfood",-6,2163
"671",2017-07-01,"ATM","noSubs","noPerson","noCat","noSubCat",-27,2136
"672",2017-07-01,"POS","noSubs","noPerson","restaurant","fastfood",-7,2129
"673",2017-07-01,"POS","noSubs","noPerson","restaurant","healthyfood",-27,2102
"674",2017-07-02,"ATM","noSubs","noPerson","noCat","noSubCat",-44,2058
"675",2017-07-02,"POS","noSubs","noPerson","shopping","groceries",-25,2033
"676",2017-07-02,"POS","noSubs","noPerson","shopping","groceries",-15,2018
"677",2017-07-02,"POS","noSubs","noPerson","restaurant","drinks",-27,1991
"678",2017-07-02,"POS","noSubs","noPerson","restaurant","fastfood",-5,1986
"679",2017-07-02,"POS","noSubs","noPerson","restaurant","fastfood",-6,1980
"680",2017-07-03,"FPP","noSubs","mother","noCat","noSubCat",117,2097
"681",2017-07-03,"POS","noSubs","noPerson","shopping","groceries",-27,2070
"682",2017-07-03,"POS","noSubs","noPerson","shopping","groceries",-20,2050
"683",2017-07-03,"POS","noSubs","noPerson","shopping","clothes",-57,1993
"684",2017-07-04,"FPP","noSubs","father","noCat","noSubCat",194,2187
"685",2017-07-04,"POS","noSubs","noPerson","shopping","healthcare",-11,2176
"686",2017-07-04,"POS","noSubs","noPerson","shopping","groceries",-22,2154
"687",2017-07-04,"POS","noSubs","noPerson","travelling","train",-17,2137
"688",2017-07-05,"POS","noSubs","noPerson","shopping","clothes",-52,2085
"689",2017-07-05,"POS","noSubs","noPerson","restaurant","fastfood",-7,2078
"690",2017-07-06,"POS","noSubs","noPerson","travelling","flights",-88,1990
"691",2017-07-06,"POS","noSubs","noPerson","restaurant","fastfood",-8,1982
"692",2017-07-06,"POS","noSubs","noPerson","shopping","groceries",-14,1968
"693",2017-07-07,"POS","noSubs","noPerson","restaurant","drinks",-16,1952
"694",2017-07-07,"POS","noSubs","noPerson","restaurant","fastfood",-10,1942
"695",2017-07-07,"POS","noSubs","noPerson","shopping","clothes",-54,1888
"696",2017-07-07,"POS","noSubs","noPerson","travelling","flights",-131,1757
"697",2017-07-07,"POS","noSubs","noPerson","restaurant","drinks",-25,1732
"698",2017-07-07,"POS","noSubs","noPerson","shopping","groceries",-14,1718
"699",2017-07-07,"POS","noSubs","noPerson","transport","subway",-2,1716
"700",2017-07-07,"POS","noSubs","noPerson","travelling","flights",-124,1592
"701",2017-07-08,"FPN","noSubs","sergi","noCat","noSubCat",-25,1567
"702",2017-07-08,"POS","noSubs","noPerson","shopping","groceries",-30,1537
"703",2017-07-08,"POS","noSubs","noPerson","restaurant","healthyfood",-30,1507
"704",2017-07-09,"ATM","noSubs","noPerson","noCat","noSubCat",-46,1461
"705",2017-07-09,"FPN","noSubs","sergi","noCat","noSubCat",-28,1433
"706",2017-07-10,"POS","noSubs","noPerson","restaurant","fastfood",-7,1426
"707",2017-07-10,"POS","noSubs","noPerson","restaurant","healthyfood",-23,1403
"708",2017-07-10,"POS","noSubs","noPerson","travelling","car",-11,1392
"709",2017-07-11,"FPP","noSubs","father","noCat","noSubCat",194,1586
"710",2017-07-11,"POS","noSubs","noPerson","transport","subway",-6,1580
"711",2017-07-11,"POS","noSubs","noPerson","shopping","clothes",-51,1529
"712",2017-07-11,"POS","noSubs","noPerson","travelling","flights",-197,1332
"713",2017-07-12,"POS","noSubs","noPerson","restaurant","fastfood",-10,1322
"714",2017-07-12,"POS","noSubs","noPerson","shopping","groceries",-30,1292
"715",2017-07-12,"POS","noSubs","noPerson","shopping","groceries",-10,1282
"716",2017-07-13,"ATM","noSubs","noPerson","noCat","noSubCat",-24,1258
"717",2017-07-14,"ATM","noSubs","noPerson","noCat","noSubCat",-37,1221
"718",2017-07-14,"POS","noSubs","noPerson","restaurant","healthyfood",-30,1191
"719",2017-07-14,"POS","noSubs","noPerson","restaurant","fastfood",-7,1184
"720",2017-07-15,"POS","noSubs","noPerson","travelling","train",-24,1160
"721",2017-07-15,"POS","noSubs","noPerson","transport","uber",-19,1141
"722",2017-07-15,"POS","noSubs","noPerson","shopping","healthcare",-18,1123
"723",2017-07-16,"ATM","noSubs","noPerson","noCat","noSubCat",-50,1073
"724",2017-07-17,"ATM","noSubs","noPerson","noCat","noSubCat",-27,1046
"725",2017-07-17,"ATM","noSubs","noPerson","noCat","noSubCat",-33,1013
"726",2017-07-17,"FPN","noSubs","biel","noCat","noSubCat",-22,991
"727",2017-07-17,"POS","noSubs","noPerson","travelling","flights",-93,898
"728",2017-07-17,"POS","noSubs","noPerson","restaurant","fastfood",-10,888
"729",2017-07-17,"POS","noSubs","noPerson","travelling","car",-18,870
"730",2017-07-18,"POS","noSubs","noPerson","restaurant","fastfood",-8,862
"731",2017-07-18,"POS","noSubs","noPerson","shopping","groceries",-18,844
"732",2017-07-18,"POS","noSubs","noPerson","shopping","groceries",-25,819
"733",2017-07-19,"ATM","noSubs","noPerson","noCat","noSubCat",-25,794
"734",2017-07-20,"POS","noSubs","noPerson","shopping","clothes",-22,772
"735",2017-07-20,"POS","noSubs","noPerson","restaurant","drinks",-25,747
"736",2017-07-20,"POS","noSubs","noPerson","shopping","groceries",-18,729
"737",2017-07-21,"FPN","noSubs","sergi","noCat","noSubCat",-25,704
"738",2017-07-21,"FPP","noSubs","mother","noCat","noSubCat",106,810
"739",2017-07-21,"POS","noSubs","noPerson","restaurant","fastfood",-9,801
"740",2017-07-22,"POS","noSubs","noPerson","restaurant","drinks",-22,779
"741",2017-07-22,"POS","noSubs","noPerson","shopping","groceries",-11,768
"742",2017-07-22,"POS","noSubs","noPerson","restaurant","healthyfood",-23,745
"743",2017-07-22,"POS","noSubs","noPerson","transport","uber",-15,730
"744",2017-07-23,"POS","noSubs","noPerson","restaurant","fastfood",-7,723
"745",2017-07-23,"POS","noSubs","noPerson","shopping","groceries",-29,694
"746",2017-07-23,"POS","noSubs","noPerson","shopping","groceries",-15,679
"747",2017-07-24,"FPN","noSubs","biel","noCat","noSubCat",-32,647
"748",2017-07-24,"POS","noSubs","noPerson","shopping","clothes",-38,609
"749",2017-07-24,"POS","noSubs","noPerson","restaurant","fastfood",-9,600
"750",2017-07-24,"POS","noSubs","noPerson","restaurant","drinks",-12,588
"751",2017-07-25,"FPN","noSubs","sergi","noCat","noSubCat",-30,558
"752",2017-07-25,"POS","noSubs","noPerson","shopping","clothes",-27,531
"753",2017-07-25,"POS","noSubs","noPerson","shopping","groceries",-11,520
"754",2017-07-25,"POS","noSubs","noPerson","restaurant","fastfood",-8,512
"755",2017-07-26,"POS","noSubs","noPerson","shopping","groceries",-21,491
"756",2017-07-26,"POS","noSubs","noPerson","shopping","groceries",-14,477
"757",2017-07-27,"ATM","noSubs","noPerson","noCat","noSubCat",-50,427
"758",2017-07-27,"POS","noSubs","noPerson","shopping","groceries",-15,412
"759",2017-07-27,"POS","noSubs","noPerson","restaurant","healthyfood",-29,383
"760",2017-07-28,"ATM","noSubs","noPerson","noCat","noSubCat",-30,353
"761",2017-07-28,"POS","noSubs","noPerson","restaurant","fastfood",-8,345
"762",2017-07-28,"POS","noSubs","noPerson","restaurant","healthyfood",-26,319
"763",2017-07-28,"POS","noSubs","noPerson","shopping","groceries",-11,308
"764",2017-07-28,"POS","noSubs","noPerson","shopping","clothes",-58,250
"765",2017-07-29,"FPN","noSubs","sergi","noCat","noSubCat",-21,229
"766",2017-07-29,"POS","noSubs","noPerson","transport","subway",-2,227
"767",2017-07-29,"POS","noSubs","noPerson","shopping","clothes",-32,195
"768",2017-07-29,"POS","noSubs","noPerson","restaurant","healthyfood",-28,167
"769",2017-07-29,"POS","noSubs","noPerson","shopping","clothes",-38,129
"770",2017-07-30,"BACS","noSubs","noPerson","noCat","noSubCat",2000,2129
"771",2017-07-30,"DD","amazon","noPerson","noCat","noSubCat",-4,2125
"772",2017-07-30,"DD","gym","noPerson","noCat","noSubCat",-40,2085
"773",2017-07-30,"DD","netflix","noPerson","noCat","noSubCat",-8,2077
"774",2017-07-30,"DD","spotify","noPerson","noCat","noSubCat",-10,2067
"775",2017-07-30,"POS","noSubs","noPerson","travelling","train",-25,2042
"776",2017-07-30,"POS","noSubs","noPerson","shopping","groceries",-19,2023
"777",2017-07-30,"POS","noSubs","noPerson","transport","subway",-2,2021
"778",2017-07-30,"POS","noSubs","noPerson","restaurant","drinks",-27,1994
"779",2017-07-30,"POS","noSubs","noPerson","shopping","groceries",-10,1984
"780",2017-07-31,"ATM","noSubs","noPerson","noCat","noSubCat",-35,1949
"781",2017-07-31,"POS","noSubs","noPerson","shopping","groceries",-22,1927
"782",2017-07-31,"POS","noSubs","noPerson","restaurant","healthyfood",-22,1905
"783",2017-08-01,"POS","noSubs","noPerson","shopping","healthcare",-18,1887
"784",2017-08-02,"POS","noSubs","noPerson","travelling","train",-28,1859
"785",2017-08-03,"ATM","noSubs","noPerson","noCat","noSubCat",-46,1813
"786",2017-08-03,"FPN","noSubs","sergi","noCat","noSubCat",-26,1787
"787",2017-08-03,"FPP","noSubs","father","noCat","noSubCat",108,1895
"788",2017-08-03,"POS","noSubs","noPerson","restaurant","drinks",-21,1874
"789",2017-08-04,"FPN","noSubs","sergi","noCat","noSubCat",-29,1845
"790",2017-08-04,"POS","noSubs","noPerson","restaurant","drinks",-23,1822
"791",2017-08-04,"POS","noSubs","noPerson","shopping","healthcare",-10,1812
"792",2017-08-05,"FPN","noSubs","sergi","noCat","noSubCat",-30,1782
"793",2017-08-05,"POS","noSubs","noPerson","travelling","train",-12,1770
"794",2017-08-05,"POS","noSubs","noPerson","restaurant","fastfood",-7,1763
"795",2017-08-05,"POS","noSubs","noPerson","shopping","groceries",-22,1741
"796",2017-08-05,"POS","noSubs","noPerson","restaurant","fastfood",-9,1732
"797",2017-08-05,"POS","noSubs","noPerson","shopping","groceries",-13,1719
"798",2017-08-06,"ATM","noSubs","noPerson","noCat","noSubCat",-28,1691
"799",2017-08-06,"FPN","noSubs","sergi","noCat","noSubCat",-31,1660
"800",2017-08-06,"POS","noSubs","noPerson","transport","subway",-6,1654
"801",2017-08-06,"POS","noSubs","noPerson","restaurant","fastfood",-9,1645
"802",2017-08-06,"POS","noSubs","noPerson","restaurant","fastfood",-8,1637
"803",2017-08-06,"POS","noSubs","noPerson","restaurant","fastfood",-5,1632
"804",2017-08-07,"FPN","noSubs","sergi","noCat","noSubCat",-31,1601
"805",2017-08-07,"POS","noSubs","noPerson","restaurant","drinks",-8,1593
"806",2017-08-07,"POS","noSubs","noPerson","shopping","groceries",-27,1566
"807",2017-08-08,"FPP","noSubs","mother","noCat","noSubCat",125,1691
"808",2017-08-08,"POS","noSubs","noPerson","shopping","groceries",-15,1676
"809",2017-08-08,"POS","noSubs","noPerson","shopping","groceries",-27,1649
"810",2017-08-08,"POS","noSubs","noPerson","restaurant","fastfood",-7,1642
"811",2017-08-08,"POS","noSubs","noPerson","restaurant","healthyfood",-22,1620
"812",2017-08-08,"POS","noSubs","noPerson","transport","bus",-7,1613
"813",2017-08-09,"POS","noSubs","noPerson","travelling","flights",-146,1467
"814",2017-08-09,"POS","noSubs","noPerson","shopping","healthcare",-11,1456
"815",2017-08-09,"POS","noSubs","noPerson","restaurant","fastfood",-5,1451
"816",2017-08-10,"ATM","noSubs","noPerson","noCat","noSubCat",-45,1406
"817",2017-08-10,"POS","noSubs","noPerson","shopping","groceries",-10,1396
"818",2017-08-10,"POS","noSubs","noPerson","travelling","car",-16,1380
"819",2017-08-10,"POS","noSubs","noPerson","restaurant","fastfood",-7,1373
"820",2017-08-10,"POS","noSubs","noPerson","restaurant","drinks",-11,1362
"821",2017-08-10,"POS","noSubs","noPerson","shopping","groceries",-21,1341
"822",2017-08-10,"POS","noSubs","noPerson","shopping","groceries",-13,1328
"823",2017-08-11,"POS","noSubs","noPerson","shopping","healthcare",-14,1314
"824",2017-08-11,"POS","noSubs","noPerson","restaurant","drinks",-28,1286
"825",2017-08-11,"POS","noSubs","noPerson","restaurant","drinks",-16,1270
"826",2017-08-12,"ATM","noSubs","noPerson","noCat","noSubCat",-26,1244
"827",2017-08-12,"FPP","noSubs","mother","noCat","noSubCat",194,1438
"828",2017-08-12,"POS","noSubs","noPerson","restaurant","drinks",-22,1416
"829",2017-08-13,"ATM","noSubs","noPerson","noCat","noSubCat",-30,1386
"830",2017-08-13,"POS","noSubs","noPerson","restaurant","drinks",-17,1369
"831",2017-08-14,"ATM","noSubs","noPerson","noCat","noSubCat",-27,1342
"832",2017-08-14,"POS","noSubs","noPerson","restaurant","fastfood",-8,1334
"833",2017-08-14,"POS","noSubs","noPerson","shopping","healthcare",-11,1323
"834",2017-08-15,"POS","noSubs","noPerson","restaurant","fastfood",-8,1315
"835",2017-08-16,"POS","noSubs","noPerson","shopping","clothes",-47,1268
"836",2017-08-16,"POS","noSubs","noPerson","transport","subway",-7,1261
"837",2017-08-17,"ATM","noSubs","noPerson","noCat","noSubCat",-28,1233
"838",2017-08-17,"POS","noSubs","noPerson","restaurant","drinks",-28,1205
"839",2017-08-18,"FPN","noSubs","sergi","noCat","noSubCat",-35,1170
"840",2017-08-18,"POS","noSubs","noPerson","restaurant","fastfood",-5,1165
"841",2017-08-18,"POS","noSubs","noPerson","shopping","groceries",-24,1141
"842",2017-08-18,"POS","noSubs","noPerson","restaurant","drinks",-11,1130
"843",2017-08-19,"POS","noSubs","noPerson","transport","uber",-12,1118
"844",2017-08-20,"POS","noSubs","noPerson","restaurant","drinks",-5,1113
"845",2017-08-21,"ATM","noSubs","noPerson","noCat","noSubCat",-24,1089
"846",2017-08-21,"POS","noSubs","noPerson","transport","subway",-6,1083
"847",2017-08-21,"POS","noSubs","noPerson","shopping","clothes",-73,1010
"848",2017-08-21,"POS","noSubs","noPerson","travelling","train",-22,988
"849",2017-08-21,"POS","noSubs","noPerson","travelling","flights",-119,869
"850",2017-08-22,"FPN","noSubs","sergi","noCat","noSubCat",-30,839
"851",2017-08-22,"FPN","noSubs","biel","noCat","noSubCat",-27,812
"852",2017-08-23,"POS","noSubs","noPerson","restaurant","drinks",-25,787
"853",2017-08-23,"POS","noSubs","noPerson","transport","uber",-15,772
"854",2017-08-24,"FPN","noSubs","sergi","noCat","noSubCat",-27,745
"855",2017-08-24,"FPN","noSubs","biel","noCat","noSubCat",-29,716
"856",2017-08-24,"POS","noSubs","noPerson","travelling","car",-18,698
"857",2017-08-24,"POS","noSubs","noPerson","shopping","healthcare",-17,681
"858",2017-08-24,"POS","noSubs","noPerson","shopping","healthcare",-12,669
"859",2017-08-24,"POS","noSubs","noPerson","travelling","flights",-107,562
"860",2017-08-26,"ATM","noSubs","noPerson","noCat","noSubCat",-30,532
"861",2017-08-26,"POS","noSubs","noPerson","shopping","groceries",-22,510
"862",2017-08-27,"ATM","noSubs","noPerson","noCat","noSubCat",-38,472
"863",2017-08-27,"POS","noSubs","noPerson","restaurant","fastfood",-7,465
"864",2017-08-27,"POS","noSubs","noPerson","restaurant","fastfood",-6,459
"865",2017-08-27,"POS","noSubs","noPerson","shopping","healthcare",-18,441
"866",2017-08-28,"POS","noSubs","noPerson","transport","bus",-2,439
"867",2017-08-29,"FPN","noSubs","sergi","noCat","noSubCat",-31,408
"868",2017-08-29,"FPP","noSubs","father","noCat","noSubCat",110,518
"869",2017-08-30,"BACS","noSubs","noPerson","noCat","noSubCat",2000,2518
"870",2017-08-30,"DD","amazon","noPerson","noCat","noSubCat",-4,2514
"871",2017-08-30,"DD","gym","noPerson","noCat","noSubCat",-40,2474
"872",2017-08-30,"DD","netflix","noPerson","noCat","noSubCat",-8,2466
"873",2017-08-30,"DD","spotify","noPerson","noCat","noSubCat",-10,2456
"874",2017-08-30,"POS","noSubs","noPerson","shopping","groceries",-16,2440
"875",2017-08-30,"POS","noSubs","noPerson","restaurant","fastfood",-7,2433
"876",2017-08-30,"POS","noSubs","noPerson","transport","subway",-2,2431
"877",2017-08-31,"POS","noSubs","noPerson","shopping","clothes",-35,2396
"878",2017-08-31,"POS","noSubs","noPerson","shopping","healthcare",-16,2380
"879",2017-08-31,"POS","noSubs","noPerson","restaurant","fastfood",-6,2374
"880",2017-08-31,"POS","noSubs","noPerson","transport","uber",-10,2364
"881",2017-09-01,"FPP","noSubs","father","noCat","noSubCat",110,2474
"882",2017-09-02,"ATM","noSubs","noPerson","noCat","noSubCat",-28,2446
"883",2017-09-02,"POS","noSubs","noPerson","restaurant","fastfood",-6,2440
"884",2017-09-02,"POS","noSubs","noPerson","shopping","groceries",-24,2416
"885",2017-09-02,"POS","noSubs","noPerson","shopping","groceries",-16,2400
"886",2017-09-03,"ATM","noSubs","noPerson","noCat","noSubCat",-22,2378
"887",2017-09-03,"POS","noSubs","noPerson","restaurant","drinks",-22,2356
"888",2017-09-03,"POS","noSubs","noPerson","shopping","groceries",-25,2331
"889",2017-09-04,"FPN","noSubs","sergi","noCat","noSubCat",-24,2307
"890",2017-09-04,"POS","noSubs","noPerson","travelling","train",-16,2291
"891",2017-09-04,"POS","noSubs","noPerson","shopping","groceries",-27,2264
"892",2017-09-04,"POS","noSubs","noPerson","restaurant","drinks",-7,2257
"893",2017-09-05,"POS","noSubs","noPerson","shopping","groceries",-23,2234
"894",2017-09-05,"POS","noSubs","noPerson","shopping","groceries",-28,2206
"895",2017-09-05,"POS","noSubs","noPerson","travelling","car",-30,2176
"896",2017-09-06,"ATM","noSubs","noPerson","noCat","noSubCat",-38,2138
"897",2017-09-06,"ATM","noSubs","noPerson","noCat","noSubCat",-37,2101
"898",2017-09-06,"FPN","noSubs","sergi","noCat","noSubCat",-20,2081
"899",2017-09-06,"FPP","noSubs","mother","noCat","noSubCat",186,2267
"900",2017-09-06,"POS","noSubs","noPerson","shopping","healthcare",-10,2257
"901",2017-09-06,"POS","noSubs","noPerson","travelling","flights",-69,2188
"902",2017-09-06,"POS","noSubs","noPerson","shopping","groceries",-30,2158
"903",2017-09-07,"FPN","noSubs","sergi","noCat","noSubCat",-26,2132
"904",2017-09-07,"POS","noSubs","noPerson","shopping","groceries",-17,2115
"905",2017-09-07,"POS","noSubs","noPerson","shopping","groceries",-17,2098
"906",2017-09-07,"POS","noSubs","noPerson","shopping","groceries",-13,2085
"907",2017-09-08,"ATM","noSubs","noPerson","noCat","noSubCat",-24,2061
"908",2017-09-08,"FPP","noSubs","father","noCat","noSubCat",127,2188
"909",2017-09-08,"POS","noSubs","noPerson","shopping","groceries",-20,2168
"910",2017-09-09,"POS","noSubs","noPerson","shopping","groceries",-10,2158
"911",2017-09-09,"POS","noSubs","noPerson","restaurant","fastfood",-7,2151
"912",2017-09-09,"POS","noSubs","noPerson","shopping","groceries",-26,2125
"913",2017-09-09,"POS","noSubs","noPerson","shopping","groceries",-27,2098
"914",2017-09-10,"POS","noSubs","noPerson","restaurant","drinks",-20,2078
"915",2017-09-10,"POS","noSubs","noPerson","restaurant","fastfood",-5,2073
"916",2017-09-11,"POS","noSubs","noPerson","restaurant","fastfood",-6,2067
"917",2017-09-11,"POS","noSubs","noPerson","travelling","train",-26,2041
"918",2017-09-11,"POS","noSubs","noPerson","shopping","groceries",-13,2028
"919",2017-09-11,"POS","noSubs","noPerson","travelling","train",-13,2015
"920",2017-09-12,"FPP","noSubs","mother","noCat","noSubCat",125,2140
"921",2017-09-12,"POS","noSubs","noPerson","restaurant","drinks",-12,2128
"922",2017-09-12,"POS","noSubs","noPerson","shopping","clothes",-36,2092
"923",2017-09-12,"POS","noSubs","noPerson","shopping","groceries",-15,2077
"924",2017-09-12,"POS","noSubs","noPerson","shopping","groceries",-30,2047
"925",2017-09-12,"POS","noSubs","noPerson","travelling","train",-14,2033
"926",2017-09-13,"POS","noSubs","noPerson","shopping","clothes",-41,1992
"927",2017-09-13,"POS","noSubs","noPerson","restaurant","drinks",-30,1962
"928",2017-09-13,"POS","noSubs","noPerson","restaurant","healthyfood",-27,1935
"929",2017-09-14,"ATM","noSubs","noPerson","noCat","noSubCat",-45,1890
"930",2017-09-14,"POS","noSubs","noPerson","shopping","clothes",-25,1865
"931",2017-09-14,"POS","noSubs","noPerson","shopping","groceries",-28,1837
"932",2017-09-16,"POS","noSubs","noPerson","shopping","groceries",-27,1810
"933",2017-09-17,"ATM","noSubs","noPerson","noCat","noSubCat",-46,1764
"934",2017-09-17,"ATM","noSubs","noPerson","noCat","noSubCat",-30,1734
"935",2017-09-17,"FPN","noSubs","sergi","noCat","noSubCat",-23,1711
"936",2017-09-17,"FPP","noSubs","father","noCat","noSubCat",102,1813
"937",2017-09-17,"POS","noSubs","noPerson","transport","subway",-5,1808
"938",2017-09-17,"POS","noSubs","noPerson","shopping","groceries",-15,1793
"939",2017-09-17,"POS","noSubs","noPerson","transport","subway",-5,1788
"940",2017-09-17,"POS","noSubs","noPerson","transport","subway",-6,1782
"941",2017-09-17,"POS","noSubs","noPerson","restaurant","drinks",-11,1771
"942",2017-09-18,"ATM","noSubs","noPerson","noCat","noSubCat",-49,1722
"943",2017-09-18,"POS","noSubs","noPerson","shopping","groceries",-25,1697
"944",2017-09-18,"POS","noSubs","noPerson","restaurant","fastfood",-10,1687
"945",2017-09-18,"POS","noSubs","noPerson","transport","subway",-2,1685
"946",2017-09-18,"POS","noSubs","noPerson","restaurant","healthyfood",-24,1661
"947",2017-09-19,"POS","noSubs","noPerson","restaurant","healthyfood",-22,1639
"948",2017-09-19,"POS","noSubs","noPerson","transport","bus",-3,1636
"949",2017-09-20,"ATM","noSubs","noPerson","noCat","noSubCat",-23,1613
"950",2017-09-20,"FPN","noSubs","sergi","noCat","noSubCat",-21,1592
"951",2017-09-20,"FPP","noSubs","father","noCat","noSubCat",105,1697
"952",2017-09-20,"POS","noSubs","noPerson","restaurant","drinks",-7,1690
"953",2017-09-20,"POS","noSubs","noPerson","travelling","train",-20,1670
"954",2017-09-20,"POS","noSubs","noPerson","shopping","clothes",-54,1616
"955",2017-09-20,"POS","noSubs","noPerson","shopping","groceries",-27,1589
"956",2017-09-21,"ATM","noSubs","noPerson","noCat","noSubCat",-36,1553
"957",2017-09-21,"FPP","noSubs","mother","noCat","noSubCat",103,1656
"958",2017-09-21,"POS","noSubs","noPerson","restaurant","fastfood",-9,1647
"959",2017-09-23,"POS","noSubs","noPerson","restaurant","fastfood",-5,1642
"960",2017-09-24,"FPN","noSubs","sergi","noCat","noSubCat",-29,1613
"961",2017-09-24,"POS","noSubs","noPerson","shopping","groceries",-15,1598
"962",2017-09-24,"POS","noSubs","noPerson","restaurant","fastfood",-5,1593
"963",2017-09-24,"POS","noSubs","noPerson","travelling","car",-19,1574
"964",2017-09-25,"FPP","noSubs","father","noCat","noSubCat",136,1710
"965",2017-09-25,"POS","noSubs","noPerson","travelling","flights",-187,1523
"966",2017-09-25,"POS","noSubs","noPerson","restaurant","fastfood",-8,1515
"967",2017-09-25,"POS","noSubs","noPerson","restaurant","fastfood",-10,1505
"968",2017-09-25,"POS","noSubs","noPerson","shopping","groceries",-26,1479
"969",2017-09-26,"ATM","noSubs","noPerson","noCat","noSubCat",-30,1449
"970",2017-09-26,"FPN","noSubs","biel","noCat","noSubCat",-37,1412
"971",2017-09-26,"POS","noSubs","noPerson","travelling","flights",-71,1341
"972",2017-09-26,"POS","noSubs","noPerson","travelling","car",-30,1311
"973",2017-09-27,"POS","noSubs","noPerson","shopping","groceries",-24,1287
"974",2017-09-27,"POS","noSubs","noPerson","shopping","groceries",-26,1261
"975",2017-09-28,"ATM","noSubs","noPerson","noCat","noSubCat",-43,1218
"976",2017-09-28,"POS","noSubs","noPerson","shopping","groceries",-22,1196
"977",2017-09-28,"POS","noSubs","noPerson","travelling","train",-10,1186
"978",2017-09-28,"POS","noSubs","noPerson","restaurant","drinks",-11,1175
"979",2017-09-28,"POS","noSubs","noPerson","restaurant","fastfood",-8,1167
"980",2017-09-28,"POS","noSubs","noPerson","shopping","groceries",-16,1151
"981",2017-09-28,"POS","noSubs","noPerson","shopping","groceries",-27,1124
"982",2017-09-29,"ATM","noSubs","noPerson","noCat","noSubCat",-47,1077
"983",2017-09-29,"POS","noSubs","noPerson","shopping","groceries",-24,1053
"984",2017-09-30,"BACS","noSubs","noPerson","noCat","noSubCat",2000,3053
"985",2017-09-30,"DD","amazon","noPerson","noCat","noSubCat",-4,3049
"986",2017-09-30,"DD","gym","noPerson","noCat","noSubCat",-40,3009
"987",2017-09-30,"DD","netflix","noPerson","noCat","noSubCat",-8,3001
"988",2017-09-30,"DD","spotify","noPerson","noCat","noSubCat",-10,2991
"989",2017-09-30,"POS","noSubs","noPerson","restaurant","healthyfood",-21,2970
"990",2017-09-30,"POS","noSubs","noPerson","travelling","car",-14,2956
"991",2017-10-01,"FPP","noSubs","mother","noCat","noSubCat",123,3079
"992",2017-10-01,"POS","noSubs","noPerson","restaurant","drinks",-28,3051
"993",2017-10-01,"POS","noSubs","noPerson","shopping","clothes",-24,3027
"994",2017-10-02,"POS","noSubs","noPerson","restaurant","drinks",-25,3002
"995",2017-10-02,"POS","noSubs","noPerson","transport","subway",-2,3000
"996",2017-10-02,"POS","noSubs","noPerson","shopping","groceries",-15,2985
"997",2017-10-02,"POS","noSubs","noPerson","travelling","train",-28,2957
"998",2017-10-02,"POS","noSubs","noPerson","travelling","flights",-134,2823
"999",2017-10-03,"FPN","noSubs","biel","noCat","noSubCat",-24,2799
"1000",2017-10-03,"POS","noSubs","noPerson","shopping","groceries",-14,2785
"1001",2017-10-03,"POS","noSubs","noPerson","restaurant","drinks",-12,2773
"1002",2017-10-03,"POS","noSubs","noPerson","restaurant","fastfood",-6,2767
"1003",2017-10-04,"FPN","noSubs","sergi","noCat","noSubCat",-38,2729
"1004",2017-10-04,"POS","noSubs","noPerson","shopping","clothes",-72,2657
"1005",2017-10-04,"POS","noSubs","noPerson","travelling","flights",-89,2568
"1006",2017-10-04,"POS","noSubs","noPerson","restaurant","fastfood",-5,2563
"1007",2017-10-04,"POS","noSubs","noPerson","shopping","clothes",-51,2512
"1008",2017-10-05,"ATM","noSubs","noPerson","noCat","noSubCat",-21,2491
"1009",2017-10-05,"FPN","noSubs","sergi","noCat","noSubCat",-28,2463
"1010",2017-10-05,"POS","noSubs","noPerson","transport","uber",-13,2450
"1011",2017-10-05,"POS","noSubs","noPerson","shopping","groceries",-11,2439
"1012",2017-10-05,"POS","noSubs","noPerson","restaurant","healthyfood",-30,2409
"1013",2017-10-05,"POS","noSubs","noPerson","transport","uber",-14,2395
"1014",2017-10-06,"FPN","noSubs","sergi","noCat","noSubCat",-35,2360
"1015",2017-10-06,"POS","noSubs","noPerson","shopping","groceries",-26,2334
"1016",2017-10-06,"POS","noSubs","noPerson","shopping","healthcare",-11,2323
"1017",2017-10-07,"POS","noSubs","noPerson","shopping","groceries",-11,2312
"1018",2017-10-08,"POS","noSubs","noPerson","restaurant","fastfood",-9,2303
"1019",2017-10-08,"POS","noSubs","noPerson","transport","uber",-14,2289
"1020",2017-10-09,"POS","noSubs","noPerson","restaurant","drinks",-13,2276
"1021",2017-10-10,"ATM","noSubs","noPerson","noCat","noSubCat",-21,2255
"1022",2017-10-10,"FPN","noSubs","biel","noCat","noSubCat",-23,2232
"1023",2017-10-10,"POS","noSubs","noPerson","restaurant","drinks",-28,2204
"1024",2017-10-11,"FPN","noSubs","sergi","noCat","noSubCat",-37,2167
"1025",2017-10-11,"FPN","noSubs","sergi","noCat","noSubCat",-32,2135
"1026",2017-10-11,"FPN","noSubs","biel","noCat","noSubCat",-25,2110
"1027",2017-10-11,"FPP","noSubs","father","noCat","noSubCat",193,2303
"1028",2017-10-12,"FPN","noSubs","sergi","noCat","noSubCat",-32,2271
"1029",2017-10-12,"FPN","noSubs","biel","noCat","noSubCat",-21,2250
"1030",2017-10-12,"POS","noSubs","noPerson","restaurant","drinks",-19,2231
"1031",2017-10-12,"POS","noSubs","noPerson","transport","uber",-20,2211
"1032",2017-10-12,"POS","noSubs","noPerson","restaurant","fastfood",-9,2202
"1033",2017-10-13,"ATM","noSubs","noPerson","noCat","noSubCat",-37,2165
"1034",2017-10-13,"POS","noSubs","noPerson","travelling","car",-29,2136
"1035",2017-10-13,"POS","noSubs","noPerson","restaurant","fastfood",-5,2131
"1036",2017-10-13,"POS","noSubs","noPerson","restaurant","healthyfood",-25,2106
"1037",2017-10-13,"POS","noSubs","noPerson","shopping","groceries",-29,2077
"1038",2017-10-13,"POS","noSubs","noPerson","shopping","clothes",-43,2034
"1039",2017-10-13,"POS","noSubs","noPerson","restaurant","drinks",-26,2008
"1040",2017-10-14,"ATM","noSubs","noPerson","noCat","noSubCat",-30,1978
"1041",2017-10-14,"FPN","noSubs","sergi","noCat","noSubCat",-31,1947
"1042",2017-10-14,"FPN","noSubs","sergi","noCat","noSubCat",-35,1912
"1043",2017-10-14,"POS","noSubs","noPerson","transport","uber",-12,1900
"1044",2017-10-14,"POS","noSubs","noPerson","restaurant","fastfood",-6,1894
"1045",2017-10-14,"POS","noSubs","noPerson","restaurant","fastfood",-7,1887
